OOOOOOOXXXX
XXOXXXOXXXX
XXOXXXOOXXX
XXOXXXOOXXX
XXOOOOOOXXX
OOOOOXOOXOX
XXXOOXOOXOX
XXXOOXOOXOX
XOXXXOOXXXX
XOXXXOOOOOO
OOOOXOOOOOO
XOOOOOOXXXX