OOOOOOOXXXX
XOXXXXOOOXO
XOXOOOOXOXO
XOXOOOOXOXO
XOOOOOOXOXO
XXXOXOOXOXO
XXXOXOOXOXX
XXXOXOOXOXX
XOOOOXOOOOO
XOXXXXOOOOO
XXXXXXOXXXX
XOOOOXOXXXX