OXXXOOOOOOOOXXX
OXXXOXXXXXXXXXX
OXXOOOXXXXXXXXX
XXOXXOXXXOXXXXX
XXOXXOXXXOXXXXX
OXOOOOOOOOOOOOOX
OXXXOXOXXXXXXXXX
OXXXOXOXXXXXXXXX
OXOOOOOOOOOOOOOO
OXXOXXXXOXXXXOXX
OXXOXXXXOXXXXOXX
OXXOXXXXOXXXXOXX
OXOOOOOOOOOOOOOX
XXXXXXOXXXXOXXXX
XXOOOOOOOOOOOOOO
XXXXXXXXXXXXXXXO