X
X
XOXXXX
XOOXOXXXOXXOXXOXX
XOOXOXXXOXXOOOOXX
XOOOOXXXOXXOXXOXX
XOOXOXXXOXXOXXOXO
XXOXOXXXOXXOXXOXO
XXXXOOOOOXXOXXOXO
XXOXOXXXOXXOXXOXO
XXOXOOOOOOOOXXOXO
XXOXOXXXOXXOXXOOO
XXOXOXXXOOOOXXXXO
XXOOOXXXOXXOXXOXO
XXOXOXXXOXXOOOOXX
XXOXOOOOOXXOXXOXX
XXXXXXXOXXXXXXXXX
XXXXOOOOXXXXXXOXO
XXXXXXXOOOOOXXOXO
XXXXXXXXXXXXXXOXO
XXXXXXXXXXXXXXOXX