OOOOOXXXXXOXXXXXXXXXX
OXXXXOXXXXOXOOOOOXXXX
OOOOOOOOXXOOOOOOXXXXX
OXXOXOXOXXOOXXXOXXXXX
OXXOXOOOOXOOXXXOXXXXX
OXOOXOXXOXOXXXXOOXXXX
XXOXXOXXOOOOXXXXOXXXX
XXOXXOXXXOXOXXXXOXXXX
XOOOOOXXXXXOXXXXOXXXX
XXOXXOOOXOXOXXXXOXXXX
XXOOXXXXXXXXXXXOOXXXX
XXXOXXXXXOXXXXXOXXXXX
XXOOOOOOXOOXXXOOXXXXX
XXXOOXXXXOXXXXOXXXXXX
XXXOOOXXXXXXXOOXXXXXX
XXXOXOXOOOOXXOXXXXXXX
XXXOXOOXXOOOOOXXXXXXX
XXXOXXOXXXXXOXXXXXXXX
XXOOOOOOXXXOOXXXXXXXX
XXXXXXXOXXXOXXXXXXXXX
XOOXXXXOOXOOXXXXXXXXX
XXXXXOXXOXOXXXXXXXXXX
XXXXXXXXOOOXXXXXXXXXX
XXXXXXXXXOXXXXXXXXXXX