X
X
XXXOOXOOXXXOOOOOXXXXX
XXXOXXXOXXXOOOOOOOOXX
XXXOXXXXXXOOXXXOXXXXX
XXOOXXXXOXOXXXXOOXXXX
XXOXXXXXOOOXXXXXOXXXX
XXOXXXXOXOXXXXOOOOOOX
XXXXXXXXXXXXXXXXOXXXX
XXOXXXXXXOOOOXXXOXXXX
XXOOXXXOOOXXXXXOOOOXX
XXXOXXXXXXXXXXXOXOXXX
XXXXXXOOXXOOOOOOXOXXX
XXXXOXOOXXXXXXOXXOXXX
XXXXOOOXXXXXXOOXXOXXX
XXXXXOXXXXXXXOOOOOXOX
XXXXXOOXXOXXOOXXXXXOX
XXXXXXOXXXXXOXXXXXXOX
XXXXXXOOXXXOOXXOXXXXX
XXXXXXXOXXXOOXXOOOOXX
XXXXXXXOOXOOOXXXXXXXX
XXXXXOXXOXOOOOOOXXXXX
XXXXXOOOOOOXOXXXXXXXX
XXXXXXXXXOXXOXXXXXXXX