XXOOOOOOOOOX
XOOXXXXXXXXO
OOXXOOOXXXXO
OXXOOXOOOOXO
OXOOXXXXXOXX
OXOXXOOOXOXX
XXOXOOXOXOXX