XXXOOXXX
XXXXOOXX
XXXXXOOX
XXXXXXOO
XXXXXXXO