XOOXXXXX
XXOOXXXX
XXXOOXXX
XXXXOOXX
XXXXXOXX