OOXXXXXX
XOOXXXXX
XXOOXXXX
XXXOOXXX
XXXXOXXX