OOOOOOOOOOOOOOO
OOOXOXXXXXXXXXX
OOOXOXOOOOOOOOO
OXXXOXOOXXOXXXX
OOOXOXOOOXOOOOX
OOOXOXOOOXOOOOX
OOXXXXXOXXOOXOX
OOOOOOOOOXOOXOX
OOOXOXOOOXOOXOX
XXXXXXXXXXOXXXO
OOOXOXOOOOXOXXX
XXXOXXOXOXOOOOO
OXOOOXOOOXOOXOO
OXOOOXOXXXXXXXO
OXOOOXOOOOOOXOO