OXXXXXXXXXXXXXX
OXXOXOOOOOOOOOO
OXXOXOXOOOOXXXX
OOOOXOXOOOOOOOO
OXXOXOXOXOOXXXO
OXXOXOXOXOOXXXO
OXOOOOOOOOOXOXO
OOOOOOOOXOOXOXO
XXXOXOXXXOOXOXO
OOOOOOOOOOOOOOX
XXXOXOXXXXOXOXX
OOOXOOXOXOOOOOO
XOXXXOXXXOXXOXX
XOXXXOXOOOOOOOX
XOXXXOXXXXXXOXX