XOOOXOXX
XOXXXXOO
XXXOOOXX
OXXOXOXO
OOXXXOXO
XOXOOOXX
XXOXXXOO
XOOOOXXO