XXXXXOOOO
XXXOOOXXX
XOOOXOXXX
XOXOOXXXX
XXXXOOOOO
XXXXXOXXO
XOOOOOXXO
XXXOXXXXX