OOOOOOOXXXOOOOO
XXXXXXOOXXOXOXX
XXXXXXOOXXOXOXX
XOOOOOOOXXOXOXX
XOOXXOOOXXXXOXX
XOXXOXXOOOOOOXX
XOXXOXXOXXXXOXX
XXXXOXXOXXXXOXX
XOXXOOOOOOXXOXX
XOXXOXXXOXXXOXX
XOXXOXXXOXXOOOO
XOOXOXXXOXXOXXX
OOOOOOXXOOOOXXX