OOOOOOOOOOOXXXX
XOXOXXXXXOXXOXX
XOXOXXXXXOXXOXX
XOOOOOOOXOXXOXX
OOXXXOXOOOOOOXX
OOXXOOOXXXXXOXX
OOOOOXXOXXXXOXX
OOOXOXXOOOOOOXX
XOXXOOOOOOXXOXX
XOXXXXXOXXXXOOO
XOXXXXXOXXOOOXX
XOOXXXXOXXOOXXX
XXOOOOOOOOOOXXX