OOOOOOOOOOOOOOOOOOOO
XXXXXXXXXXXXXXXXXXXO
XXXXXXXXXXXXXXXXXXXO
XXXXXXXXXXXXXXXXXXXO
XXXXXXXXXXXXXXXXXXXO
XXXXXXXXXXXXXXXXXXXO
XXXXXXXXXXXXXXXXXXXO
OOOOOOOOOOOOOOOOOOOO
OXXXXXXXXXXXXXXXXXXX
OXXXXXXXXXXXXXXXXXXX
OXXXXXXXXXXXXXXXXXXX
OXXXXXXXXXXXXXXXXXXX
OXXXXXXXXXXXXXXXXXXX
OXXXXXXXXXXXXXXXXXXX
OOOOOOOOOOOOOOOOOOOOOOOOOOOOOO
XXXXXXXXXXXXXXXXXXXXXXXXXXXXXO
XXXXXXXXXXXXXXXXXXXXXXXXXXXXXO
XXXXXXXXXXXXXXXXXXXXXXXXXXXXXO
XXXXXXXXXXXXXXXXXXXXXXXXXXXXXO
XXXXXXXXXXXXXXXXXXXXXXXXXXXXXO