XXXXXXXXXXXXXXXXXXXXXXXXXXXXXXX
XXOOOXOXXOXOXXXOX
XXXOXXOXXOXOOXOO
XXXOXXOXXOXXOOOX
XXXOXXOOOOXXOOOX
XXXOXXOXXOXOOXOO
XXXOXXOXXOXOXXXO
XXXXXXXXXXXXXXXXXXXXXXXXXXXXXXX
XOOOXOOOXOOOXXXX
XOXXXOXOXOXOXXXX
XOXXXOXOXOOOXXXX
XOOXXOXOXOOXXXXX
XOXXXOXOXOXOXXXX
XOXXXOOOXOXXOXXX
XXXXXXXXXXXXXXXXXXXXXXXXXXXXXXX
OOOXOXXXOOOXOXOXOXOXXOXOOOO
OXOXOXXXOXOXOXOXOXOOXOXOXXX
OOOXOXXXOOOXOOOXOXOOXOXOXXX
OXXXOXXXOXOXXOXXOXOXOOXOXOO
OXXXOXXXOXOXXOXXOXOXOOXOXXO
OXXXOOOXOXOXXOXXOXOXXOXOOOO
XXXXXXXXXXXXXXXXXXXXXXXXXXXXXXX