OOOOOOOOOOOOOOOOOO
OOOOOOOOOOOOOOOOOO
XXXXXXXXXXXXXXXXXX
XXXXXXXXXXXXXXXXXX
OOOOOOOOOOOOOOOOOO
XXXXXXOOOOOOXXXXXX
XXXXXXXXXXXXXXXXXX
XXXXXXXXXXXXXXXXXX
OOOOOOOOOOOOOOOOOO
XXXXXXXXXXXXXXXXXX
OOOOOOOOOXOOOOOOOO
XXXXXXXXXXXXXXXXXX