XXXXXXXXXXXX
XOXXXXXXXXXX
XOXXXXXXXXXX
XOXOOOOOOOOX
XOXXXXXXXXOX
XXXOXXXXXXOX
XXXOOOOOXXOX
XXOOOOOOOOOX
OOOOOXXOXXXX
OOOOXXXOOOOX
XXXXXXXXOOOO
OOOOOOOOXXXX