XXXXXXXXXXXXX
XXOXXXXXXXXXX
XXOOOOOOOOXXX
XXOXOOOOOOOOX
XXOXXXXXXXXXX
XXXXOXXXXXXOX
XXXXOXXXXXXOX
XXXOOOOOOOOOX
OOOOOOOOOXXOX
XOOOOXXXOXXXX
XXXXXXXXOOOOX
XXXOOOOOOXXXX